8
1,7,5,5,7,7,5,4
3,12,1,5,13,13,5,6
10,3,5,5,5,7,5,12
10,9,4,3,6,9,5,6
10,3,6,9,14,1,7,14
10,10,11,7,14,3,15,14
10,10,11,15,14,9,15,14
9,12,9,13,12,1,13,12
